//Probadores - Fitting rooms
Ambos :		Both

Actuar :	Act

Addemás	:	besides (Anyway)

Alimentar :	(to) feed

Alimentó :	Fed

Amanecer :	Dawn

Atardecer :	Dusk

Boletos :	Tickets

Burros :	Donkeys

Botellas :	Bottles

Buscas	:	Looking for

Cabras :	Goats

Cargo :		In charge / position

Cierto :	True

Colocar :	place

Compromiso :	Commitment

Cosecha : 	Harvest (Gather food)

//Cualquier :	

Cria :		(he / she) raise / breed

Crían :		(they) raise / breed

Cultiva :	Grows / Farms

Curso :		Course

Deletrear :	Spell

Desarrollado :	Developing

//Elaborado :	

Esfuerzos :	Efforts

Éxito :		Success

Explicar :	Explain

Fracasco :	failure

Iban :		were going

Parejas	:	Couples

Pedido : 	Asked

Probar	:	try out

Profundo :	Steep / Deep

Propuesta :	Proposal

Prueba : 	test

Puesto : 	Put

Puestos : 	positions / places

Secilla :	Simple / Plain / Straightforward

Quizás :	Perhaps

Iniciar :	Start

Inundación :	Flood

Llegar :	(to) Arrive

Llega	:	Arrives

llegado	:	Arrived

llevar :	Carry

llevó :		Carried

llevado :	Worn

Recursos :	Resourcess

Regando :	Watering (I am)

Regar :		(to) Water

Reúnen :	(they) meet

Riega : 	Waters (verb)

Salta :		Jumps

Sentido : 	Felt

Sequía :	Drought

Sombra :	Shadow

Sube :		Climbs

Tenido :	had

Tomado :	Taken

Vivido :	Lived

Venido :	(he/she) Come

Visto :		(I) seen

Cocinado :	Cooked

Hablado :	Spoken

//llevado	:	Taken

Dejado	:	Left

//Él jamás había sentido esto por nadie	:	He had never felt this for anyone
// engid 26 true verdadera 	Error in saveToDb duplicate key value violates unique constraint "pairengesp_engid_key" DETAIL:  Key (engid)=(26) already exists.

// engid 60 taken llevado	Error in saveToDb duplicate key value violates unique constraint "pairengesp_engid_key" DETAIL:  Key (engid)=(60) already exists.
//No voy a ninguna parte	:	 I am not going anywhere

//tratar ? intentar

